9 1 2  7 
 53  76 2
  49 6 31
 3      5
4 7   3 6
5      4 
67 1 92  
1 58  46 
 4  7 1 9
